█████████████████████████████
█           █               █
█  $        █               D
█           ████████        █
█       █                   █
█       █     X     B       █
█       █                   █
█████████████████████████████