███d█████████████████████████████████
█                           █   █►$◀︎█
D           █               █X█ █►$◀︎█
█           █               █ █ █►$◀︎█
█           ████████        █ █ █► ◀︎█
█                           █ █X█► ◀︎█
█                           █ █ █► ◀︎█
█                             █    ◀︎█
████████████████████████████████   ◀︎█
█             X                    ◀︎█
█ ♨︎        B    X                  ◀︎█
█             X                    ◀︎█
█████████████████████████████████████
             █  ♨︎  █
             █ $$$ █ 
             ███ ███