█████████████████████████████
█           █               █
█  $        █   P           █
█           ████████        █
█       █                   █
█       █     $     $       █
█       █                   █
███d█████████████████████████