█████████████████████████████
█           █               █
█  $        █               █
█           ████████        █
█       █                   █
█       █     $     $       █
█       █                   █
███d█████████████████████████