█████████████████████████████
█           █               █
█  $        █S  P           █
█           ████████        █
█       █                   █
█       █     $     $       █
█       █                   █
███d█████████████████████████